     A#########
# ###   #  ####
## ##  ########
 #####    #####
#  #####    ###
####     #     
# ##   ########
   ###  #######
##B        ####
###############