       ######  ##
A#   ##   #######
    ## ###  ### #
 ##    ####  ## #
##  ### ## ##    
## #  # #######  
     ### #  # #  
    #          ##
  ##  # #####  # 
#    ## ##     # 
  #####    ###   
 #  ##### ####B  